x from -33 to 19
y from -19 to 7
212 images, 5.8 megabytes

(#*000000000000000000000000000000011000000000000000000000000000000000000000000000000
 #*000000000000000000000000000000010000000000000000000000000001000000000000000000000
 #*000000000000000000000000000000010000000000000000000000000011100000000000000000000
 #*000000000000000000000000000000011000000000000000000000000111110000000000000000000
 #*000000000000000000000000000000010000000000000000000000001111111000000000000000000
 #*000000000000000000000000000000110011000000000000000000011111111100000000000000000
 #*000000000001000000000000000001111001111000000000110000111111111110000001000000000
 #*111111111111111111111111111111111111111111111111111111111111111111111111111111111
 #*000000000000000010000000000100000000000100000000000000000000000000000000000000000
 #*000000000000000010000000000000000000000100000000000000000000000000000000000000000
 #*000000000000000010000000000000000000000100000000000000000000000000000000000000000
 #*000000000000000010000000000000000000000100000000000000000000000000000000000000000
 #*000000000000000010000000000000000000000100000000000000000000000000000000000000000
 #*000000000000000010000000000000000000000100000000000000000000000000000000000000000
 #*000000000000000010000000000000000000000100000000000000000000000000000000000000000
 #*000000000000000010000000000000000000000100000000000000000000000000000000000000000
 #*000000000000000010000000000000000000000100000000000000000000000000000000000000000
 #*000000000000000010000000000000000000000100000000000000000000000000000000000000000
 #*000000000000000010000010000000000000000100000000000000000000000000000000000000000
 #*000000000000000011111111110000000000000100000000000000000000000000000000000000000
 #*000000000000000000000000011100000000000100000000000000000000000000000000000000000
 #*000000000000000000000000001111111111000100000000000000000000000000000000000000000
 #*000000000000000000000000000000001100000100000000000000000000000000000000000000000
 #*000000000000000000000000000000000100001110000000000000000000000000000000000000000
 #*000000000000000000000000000000000111011110000000000000000000000000000000000000000
 #*000000000000000000000000000000000001100010000000000000000000000000000000000000000
 #*000000000000000000000000000000000000111110000000000000000000000000000000000000000)
